C 47,107,204
EA ./texture/bricks/CASTLEBRICKS.ppm
F 32, 89 ,  29
WE ./texture/indus/PIPES.ppm
SO ./texture/wood/TRUNKS.ppm
NO ./texture/rocks/SLIMROCKS.ppm




111111111111111
100000000000001
101101100001001
101000000100001
101111000000001
100000000000101
100000000000001
1000000N0000001
1000000000000011111111111
1000000000000000000010001
1000000000000010000000001
1011010001100111111111111
111011011010101
100100001000011
100000000000001
111111111111111