NO ./texture/bricks/CLAYBRICKS.ppm
SO ./texture/indus/HEXAGONS.ppm
F 158,10,76
EA ./texture/wood/BIGTRUNK.ppm
WE ./texture/bricks/CASTLEBRICKS.ppm

C 42,0,126

111111111111111111111111111111111111
100000000E00000000000000000000000001
111011111111111111111111111111111111
  101
  101
  101
  101
  101
  101
  101
  101
  101
  101
  101
  101
  101
  111
