NO ./texture/rocks/LAVAROCKS.ppm
SO ./texture/rocks/LAVAROCKS.ppm
WE ./texture/rocks/LAVAROCKS.ppm
EA ./texture/rocks/LAVAROCKS.ppm


F 60,50,60
C 8,34,42

11111111111111111111
10000000000000000001
10000000000000000001
10001000000000000001
10000000000000000001
10000000000000000001
1000000E000000000001
10000000000000011111
10000000000000000001
10000000000000000001
11111111111111111111
